# 0=N 1=E 2=S 3=W

0 xE** -> N 0
0 *x** -> E 1
0 NEx* -> W 3
0 NEW* -> S 2
1 *x*S -> E 1
1 ***x -> S 2
1 xE*S -> N 0
1 NE*S -> W 3
2 **Wx -> S 2
2 **x* -> W 3
2 *EWS -> N 0
2 *xWS -> E 1
3 N*x* -> W 3
3 x*** -> N 0
3 N*Wx -> S 2
3 N*WS -> E 1
