# 0=N 1=E 2=S 3=W


0 *x** -> E 1
0 *E** -> x 3

1 ***x -> S 2
1 ***S -> x 0

2 **x* -> W 3
2 **W* -> x 1

3 x*** -> N 0
3 N*** -> x 2
